11111111111111111111111
1000000C000000000000001
1001011111C00001C000001
10010C0000000O010000001
1O010000000000010000O01
1001O0000000000C0000001
1P011E0000O000000010001
100000000000000000100C1
1C0100000000C0000010001
100100C00000O0000010001
10010000000000000000001
11111111111111111111111