11111111111111111111111
10000000000000000000001
1001011111C00001C000001
10010C00000000010000001
10010000000000010000001
100100000000000C0000001
1P011E00000000000010001
100000000000000000100C1
100100000000C0000010001
10010000000000000010001
10010000000000000000001
11111111111111111111111